{
    "1": {
        "mapW": 20,
        "mapH": 20,

        "exits": {
            "2,4": {
                "level": 2,
                "entryTile": {
                    "x": 1,
                    "y": 1
                }
            }
        },

        "itemStacks": [
            {
                "x": 5,
                "y": 5,
                "items": [
                    {
                        "type": 1,
                        "quantity": 2
                    },
                    {
                        "type": 2,
                        "quantity": 2
                    }
                ]
            }
        ],

        "mapObjects": [
            {
                "type": 1,
                "x": 3,
                "y": 3
            },
            {
                "type": 2,
                "x": 3,
                "y": 4
            },
            {
                "type": 1,
                "x": 6,
                "y": 3
            },
            {
                "type": 2,
                "x": 8,
                "y": 3
            },
            {
                "type": 3,
                "x": 4,
                "y": 5
            },
            {
                "type": 3,
                "x": 4,
                "y": 8
            },
            {
                "type": 3,
                "x": 4,
                "y": 11
            },
            {
                "type": 3,
                "x": 2,
                "y": 6
            },
            {
                "type": 3,
                "x": 2,
                "y": 9
            },
            {
                "type": 3,
                "x": 2,
                "y": 12
            }
        ],

        "npcs": [
            {
                "id": 1,
                "x": 9,
                "y": 9
            },
            {
                "id": 3,
                "x": 4,
                "y": 4
            }
        ],

        "data": [
            0, 0, 0, 4, 0, 0, 0, 0, 0, 0, 0, 0, 0, 0, 0, 0, 0, 0, 0, 0,
        	0, 2, 2, 4, 1, 1, 1, 7, 7, 7, 1, 1, 1, 1, 1, 1, 0, 2, 2, 0,
        	0, 2, 3, 4, 4, 1, 1, 8, 1, 1, 1, 1, 1, 1, 1, 1, 0, 2, 2, 0,
        	0, 2, 3, 1, 4, 4, 1, 8, 2, 2, 2, 2, 1, 1, 2, 2, 2, 2, 2, 0,
        	0, 2, 10, 1, 1, 4, 4, 8, 2, 3, 3, 2, 1, 1, 2, 1, 0, 0, 0, 0,
        	0, 2, 2, 2, 2, 2, 2, 2, 2, 3, 3, 2, 2, 2, 2, 1, 1, 1, 1, 0,
        	0, 5, 1, 1, 2, 2, 4, 1, 1, 1, 1, 1, 1, 1, 2, 1, 1, 1, 1, 0,
        	0, 5, 5, 5, 5, 2, 4, 1, 1, 1, 1, 6, 6, 6, 2, 1, 1, 1, 1, 0,
        	0, 1, 5, 1, 5, 2, 4, 4, 4, 4, 4, 8, 1, 1, 2, 2, 2, 2, 1, 0,
        	0, 1, 5, 1, 5, 2, 3, 2, 1, 1, 4, 8, 1, 1, 1, 3, 3, 2, 1, 0,
        	0, 1, 2, 2, 2, 2, 1, 2, 1, 1, 4, 8, 1, 1, 1, 1, 3, 2, 1, 0,
        	0, 1, 2, 3, 3, 2, 1, 2, 1, 1, 4, 4, 4, 4, 4, 4, 4, 2, 4, 4,
        	0, 1, 2, 3, 3, 2, 1, 2, 1, 1, 1, 1, 1, 1, 1, 1, 1, 2, 1, 0,
        	0, 1, 2, 3, 4, 2, 2, 2, 1, 1, 1, 1, 1, 1, 1, 0, 1, 2, 1, 0,
        	0, 3, 2, 3, 4, 4, 1, 2, 2, 2, 2, 2, 2, 2, 1, 0, 1, 2, 1, 0,
        	0, 3, 2, 3, 4, 4, 3, 2, 1, 1, 1, 1, 1, 2, 1, 1, 1, 2, 3, 0,
        	0, 3, 2, 3, 4, 1, 3, 2, 1, 3, 1, 1, 1, 2, 1, 1, 1, 2, 3, 0,
        	0, 1, 2, 2, 2, 2, 2, 2, 3, 3, 3, 1, 1, 2, 2, 2, 2, 2, 3, 0,
        	0, 1, 1, 1, 1, 1, 1, 3, 3, 3, 3, 3, 1, 1, 1, 1, 1, 2, 4, 0,
        	0, 0, 0, 0, 0, 0, 0, 0, 0, 0, 0, 0, 0, 0, 0, 0, 0, 0, 0, 0
        ]
    },

    "2": {
        "mapW": 29,
        "mapH": 29,

        "exits": {
            "2,2": {
                "level": 1,
                "entryTile": {
                    "x": 1,
                    "y": 1
                }
            }
        },

        "itemStacks": [
            {
                "x": 4,
                "y": 4,
                "items": [
                    {
                        "type": 1,
                        "quantity": 2
                    }
                ]
            }
        ],

        "mapObjects": [],

        "npcs": [
            {
                "id": 2,
                "x": 11,
                "y": 4
            }
        ],

        "data": [
            0, 0, 0, 0, 0, 0, 0, 0, 0, 0, 0, 0, 0, 0, 0, 0, 0, 0, 0, 0, 0, 0, 0, 0, 0, 0, 0, 0, 0,
            0, 2, 2, 2, 2, 2, 0, 0, 0, 2, 2, 2, 2, 0, 0, 0, 2, 2, 2, 2, 0, 0, 0, 2, 2, 2, 2, 5, 0,
            0, 2, 10, 2, 2, 2, 0, 0, 0, 2, 2, 2, 2, 0, 0, 0, 2, 2, 2, 2, 0, 0, 0, 2, 2, 2, 2, 2, 0,
            0, 2, 2, 2, 2, 2, 2, 2, 2, 2, 2, 2, 2, 2, 2, 2, 2, 2, 2, 2, 2, 2, 2, 2, 2, 2, 2, 2, 0,
            0, 2, 2, 2, 2, 2, 2, 2, 2, 2, 2, 2, 2, 2, 2, 2, 2, 2, 2, 2, 2, 2, 2, 2, 2, 2, 2, 2, 0,
            0, 2, 2, 2, 2, 2, 2, 2, 2, 2, 2, 2, 2, 2, 2, 2, 2, 2, 2, 2, 2, 2, 2, 2, 2, 2, 2, 2, 0,
            0, 0, 0, 2, 2, 2, 0, 0, 0, 2, 2, 2, 2, 0, 0, 0, 2, 2, 2, 2, 0, 0, 0, 2, 2, 2, 0, 0, 0,
            0, 0, 0, 2, 2, 2, 0, 0, 0, 2, 2, 2, 2, 0, 0, 0, 2, 2, 2, 2, 0, 0, 0, 2, 2, 2, 0, 0, 0,
            0, 0, 0, 2, 2, 2, 0, 0, 0, 2, 2, 2, 2, 0, 0, 0, 2, 2, 2, 2, 0, 0, 0, 2, 2, 2, 0, 0, 0,
            0, 2, 2, 2, 2, 2, 2, 2, 2, 2, 2, 2, 1, 1, 1, 1, 1, 2, 2, 2, 2, 2, 2, 2, 2, 2, 2, 2, 0,
            0, 2, 2, 2, 2, 2, 2, 2, 2, 2, 2, 1, 1, 4, 4, 4, 1, 1, 2, 2, 2, 2, 2, 2, 2, 2, 2, 2, 0,
            0, 2, 2, 2, 2, 2, 2, 2, 2, 2, 1, 1, 4, 4, 4, 4, 4, 1, 1, 2, 2, 2, 2, 2, 2, 2, 2, 2, 0,
            0, 2, 2, 2, 2, 2, 2, 2, 2, 1, 1, 4, 4, 4, 4, 4, 4, 4, 1, 1, 2, 2, 2, 2, 2, 2, 2, 2, 0,
            0, 0, 0, 2, 2, 2, 0, 0, 0, 1, 4, 4, 4, 4, 0, 4, 4, 4, 4, 1, 0, 0, 0, 2, 2, 2, 0, 0, 0,
            0, 0, 0, 2, 2, 2, 0, 0, 0, 1, 4, 4, 4, 0, 0, 0, 4, 4, 4, 1, 0, 0, 0, 2, 2, 2, 0, 0, 0,
            0, 0, 0, 2, 2, 2, 0, 0, 0, 1, 4, 4, 4, 4, 0, 4, 4, 4, 4, 1, 0, 0, 0, 2, 2, 2, 0, 0, 0,
            0, 2, 2, 2, 2, 2, 2, 2, 2, 1, 1, 4, 4, 4, 4, 4, 4, 4, 1, 1, 2, 2, 2, 2, 2, 2, 2, 2, 0,
            0, 2, 2, 2, 2, 2, 2, 2, 2, 2, 1, 1, 4, 4, 4, 4, 4, 1, 1, 2, 2, 2, 2, 2, 2, 2, 2, 2, 0,
            0, 2, 2, 2, 2, 2, 2, 2, 2, 2, 2, 1, 1, 4, 4, 4, 1, 1, 2, 2, 2, 2, 2, 2, 2, 2, 2, 2, 0,
            0, 2, 2, 2, 2, 2, 2, 2, 2, 2, 2, 2, 1, 1, 1, 1, 1, 2, 2, 2, 2, 2, 2, 2, 2, 2, 2, 2, 0,
            0, 0, 0, 2, 2, 2, 0, 0, 0, 2, 2, 2, 2, 0, 0, 0, 2, 2, 2, 2, 0, 0, 0, 2, 2, 2, 0, 0, 0,
            0, 0, 0, 2, 2, 2, 0, 0, 0, 2, 2, 2, 2, 0, 0, 0, 2, 2, 2, 2, 0, 0, 0, 2, 2, 2, 0, 0, 0,
            0, 0, 0, 2, 2, 2, 0, 0, 0, 2, 2, 2, 2, 0, 0, 0, 2, 2, 2, 2, 0, 0, 0, 2, 2, 2, 0, 0, 0,
            0, 2, 2, 2, 2, 2, 2, 2, 2, 2, 2, 2, 2, 2, 2, 2, 2, 2, 2, 2, 2, 2, 2, 2, 2, 2, 2, 2, 0,
            0, 2, 2, 2, 2, 2, 2, 2, 2, 2, 2, 2, 2, 2, 2, 2, 2, 2, 2, 2, 2, 2, 2, 2, 2, 2, 2, 2, 0,
            0, 2, 2, 2, 2, 2, 2, 2, 2, 2, 2, 2, 2, 2, 2, 2, 2, 2, 2, 2, 2, 2, 2, 2, 2, 2, 2, 2, 0,
            0, 2, 2, 2, 2, 2, 0, 0, 0, 2, 2, 2, 2, 0, 0, 0, 2, 2, 2, 2, 0, 0, 0, 2, 2, 2, 2, 2, 0,
            0, 5, 2, 2, 2, 2, 0, 0, 0, 2, 2, 2, 2, 0, 0, 0, 2, 2, 2, 2, 0, 0, 0, 2, 2, 2, 2, 2, 0,
            0, 0, 0, 0, 0, 0, 0, 0, 0, 0, 0, 0, 0, 0, 0, 0, 0, 0, 0, 0, 0, 0, 0, 0, 0, 0, 0, 0, 0
        ]
    }
}
